000000000000000000000000
000000000000000000000000
000000000000001111000000
000000000000000000000000
000000000110010000000000
000000000110000000300001
020040300030501105000011
111111111111111111111111
111111111111111111111111